xxxxxxxxxxxxxxxx
x x            x
xx             x
x              x
x      xx      x
x vvvv fx vvvv x
x      xx      x
x  ss  xx  ss  x
x vvvv xx vvvv x
xxxxxxxxxxxxxxxx
